-12
12
-6
6
0000000000000000000000000
1111111111111111111111110
0000000000000111111100000
0000000000000111111100000
0000000010000111111100000
0000000000000111111100000
0000000000100111111100000
0000000000000111111100000
0001000000000111111100000
0000000000000000000000000
0000000000000001000000100
0000000000000000000000000
0000000010000000000000000
