-24
26
-19
16
000000000000000000000000000000000000000000000000000
000000000000000000000000000000000000000000000000000
000000000000000000000000000000000000000000000000000
000000000000000000000000000000000000000000000000000
000000111111111111111111111111111111111111100000000
000000100000000000000000000000000000000000100000000
000000100000111111111111111111111111110000100000000
000000100000100000000000000000000000010000100000000
000000100000100000000000000000000000010000100000000
000000100000100000000000000000000000010000100000000
000000100000100000000000000000000000010000100000000
000000100000100000000000000000000000010000100000000
000000100000100000000000011111110000010000100000000
000000100000100000000000011111110000010000100000000
000000100000100000001000011111110000010000100000000
000000100000100000000000011111110000010000100000000
000000100000100000000010011111110000010000100000000
000000100000100000000000011111110000010000100000000
000000100000100100000000011111110000010000100000000
000000100000100000000000000000000000010000100000000
000000100000100000000000000100000010010000100000000
000000100000100000000000000000000000010000100000000
000000100000100000001000000000000000010000100000000
000000100000100000000000000000000000010000100000000
000000100000100000000000000000000000010000100000000
000000100000100000000000000000000000010000100000000
000000100000100000000000000000000000010000100000000
000000100000100000000000000000000000010000100000000
000000111111111111111111111111111111111111100000000
000000111111111111111111111111111111111111100000000
000000111111111111111111111111111111111111100000000
000000111111111111111111111111111111111111100000000
000000111111111111111111111111111111111111100000000
000000000000000000000000000000000000000000000000000
000000000000000000000000000000000000000000000000000
000000000000000000000000000000000000000000000000000
